Columns: 10
Rows: 10
TileSize: 32
0000000023
0100010045
0010000000
0000232300
0001454500
0000000000
1000000001
0000000000
0000000010
0011001111